02,02,02,02,02,02,02,02,02,02,02,02,02,02,02,02,02,02,02,02
02,00,01,00,01,00,01,00,01,00,01,00,01,00,01,00,01,00,01,02
02,10,11,10,11,10,11,10,11,10,11,10,11,10,11,10,11,10,11,02
02,00,01,00,01,00,01,00,01,00,01,00,01,00,01,00,01,00,01,02
02,10,11,10,11,10,11,10,11,10,11,10,11,10,11,10,11,10,11,02
02,00,01,00,01,00,01,00,01,00,01,00,01,00,01,00,01,00,01,02
02,10,11,10,11,10,11,10,11,10,11,10,11,10,11,10,11,10,11,02
02,00,01,00,01,00,01,00,01,00,01,00,01,00,01,00,01,00,01,02
02,10,11,10,11,10,11,10,11,10,11,10,11,10,11,10,11,10,11,02
02,00,01,00,01,00,01,00,01,00,01,00,01,00,01,00,01,00,01,02
02,10,11,10,11,10,11,10,11,10,11,10,11,10,11,10,11,10,11,02
02,00,01,00,01,00,01,00,01,00,01,00,01,00,01,00,01,00,01,02
02,10,11,10,11,10,11,10,11,10,11,10,11,10,11,10,11,10,11,02
02,00,01,00,01,00,01,00,01,00,01,00,01,00,01,00,01,00,01,02
02,10,11,10,11,10,11,10,11,10,11,10,11,10,11,10,11,10,11,02
02,00,01,00,01,00,01,00,01,00,01,00,01,00,01,00,01,00,01,02
02,10,11,10,11,10,11,10,11,10,11,10,11,10,11,10,11,10,11,02
02,00,01,00,01,00,01,00,01,00,01,00,01,00,01,00,01,00,01,02
02,10,11,10,11,10,11,10,11,10,11,10,11,10,11,10,11,10,11,02
02,02,02,02,02,02,02,02,02,02,02,02,02,02,02,02,02,02,02,02